小豚当家=小豚当家
对方离线=对方离线
对方正在通话中=对方正在通话中
对方已挂断=对方已挂断
连接超时=连接超时
对方正在留言中=对方正在留言中
通话结束=通话结束
操作成功=操作成功
操作失败=操作失败
网络不给力=网络不给力
您已在别处登录，请重新登录=您已在别处登录,请重新登录
系统正在维护，请稍后再试=系统正在维护,请稍后再试
手机号已被使用，请换个别的手机号试试=手机号已被使用,请换个别的手机号试试
密码错误=密码错误
密码错误，您还有%s次尝试机会=密码错误,您还有%@次尝试机会
验证码不正确=验证码不正确
验证码不存在或已失效=验证码不存在或已失效
账号不存在，请先注册账号=账号不存在,请先注册账号
用户不存在=用户不存在
暂不支持输入表情=暂不支持输入表情
短时间内密码错误次数过多，请%s分钟后再次登录=短时间内密码错误次数过多,请%@分钟后再次登录
该设备不是一台合法的设备=该设备不是一台合法的设备
您已经拥有该设备了=您已经拥有该设备了
设备已被其他人绑定了=设备已被其他人绑定了
设备不存在=设备不存在
设备已经创建群了，不需要重复创建=设备已经创建群了,不需要重复创建
您不是这个设备的主人，不能完成这个操作=您不是这个设备的主人,不能完成这个操作
设备未绑定=设备未绑定
请先将该设备从群中移除才能解绑=请先将该设备从群中移除才能解绑
设备已经加入了其他群=设备已经加入了其他群
您不是这个群的群主，没有管理这个群的权限！=您不是这个群的群主,没有管理这个群的权限!
群不存在=群不存在
权限不足=权限不足
群成员达到上限=群成员达到上限
群的数量达到上限=群的数量达到上限
您已经是群成员了=您已经是群成员了
群成员不存在=群成员不存在
这条消息已经过期了=这条消息已经过期了
设备更新=设备更新
该国家码暂不支持发送手机短信=该国家码暂不支持发送手机短信
扫一扫=扫一扫
将二维码放入框内，即可自动扫描=将二维码放入框内,即可自动扫描
账号=账号
手机号=手机号
密码=密码
登录=登录
注册=注册
获取验证码=获取验证码
验证码=验证码
确认密码=确认密码
确定=确定
忘记密码=忘记密码
群组=群组
设备=设备
我的=我的
微信公众号=微信公众号
联系客服=联系客服
关于小豚=关于小豚
帮助与反馈=帮助与反馈
检查更新=检查更新
发现新版本=发现新版本
连接设备=连接设备
连接WiFi=连接WiFi
等待连接=等待连接
取消=取消
选择WiFi=选择WiFi
%s秒后自动挂断，是否继续保持通话？=%@秒后自动挂断,是否继续保持通话?
挂断=挂断
继续=继续
管理群(%s)=管理群(%@)
官网=官网
服务协议=服务协议
用户头像=用户头像
修改昵称=修改昵称
我的手机=我的手机
修改密码=修改密码
退出登录=退出登录
账户信息=账户信息
查看大图=查看大图
拍照=拍照
相册选择=相册选择
请输入群名=请输入群名
%s人=%@人
扫一扫上面的二维码即可进群=扫一扫上面的二维码即可进群
添加设备=添加设备
创建群=创建群
扫码加群=扫码加群
加入群=加入群
请输入昵称=请输入昵称
设置=设置
设备名称=设备名称
室内机音量=室内机音量
室外机音量=室外机音量
设备音乐=设备音乐
设备电量=设备电量
设备ID=设备ID
设备型号=设备型号
解绑设备=解绑设备
固件版本=固件版本
选择音乐=选择音乐
系统消息=系统消息
确定删除系统消息？=确定删除系统消息?
手指上滑，取消发送=手指上滑,取消发送
松开手指，取消发送=松开手指,取消发送
未获取到=未获取到
确定将该用户移出本群吗？=确定将该用户移出本群吗?
您不是这个群的群主，没有管理这个群的权限=您不是这个群的群主,没有管理这个群的权限
删除这最后一个成员之后，该群将被自动解散，确定要这么做吗？=删除这最后一个成员之后,该群将被自动解散,确定要这么做吗?
确定要这么做吗？=确定要这么做吗?
我知道了=我知道了
未获取到该群的信息=未获取到该群的信息
必需先添加设备才能创建新群，现在就去添加设备吗？=必需先添加设备才能创建新群,现在就去添加设备吗?
现在就去=现在就去
确定删除？=确定删除?
今天=今天
昨天=昨天
前天=前天
拨打  400 8785 787=拨打  400 8785 787
无法识别的消息=无法识别的消息
%s呼叫了你一次=%@呼叫了你一次
电量低=电量低
播放失败=播放失败
您已被移出本群=您已被移出本群
消息发送失败，是否重新发送？=消息发送失败,是否重新发送?
准备门铃设备=准备门铃设备
装上电池，然后查看门铃是否蓝灯闪烁=装上电池,然后查看门铃是否蓝灯闪烁
最新版本=最新版本
下次再说=下次再说
立即更新=立即更新
新版本已下载，是否立即更新=新版本已下载,是否立即更新
设备暂不支持5G的WiFi=设备暂不支持5G的WiFi
下一步=下一步
获取周围的WiFi失败，请确保手机系统开启了定位功能和WiFi开关，并且允许小豚当家APP使用定位权限，当然您也可以手动输入=获取周围的WiFi失败,请确保手机系统开启了定位功能和WiFi开关,并且允许小豚当家APP使用定位权限,当然您也可以手动输入
确定这个WiFi没有密码吗？=确定这个WiFi没有密码吗?
门铃对WiFi有什么要求？=门铃对WiFi有什么要求?
%1$s正在与%2$s通话=%1$@正在与%2$@通话
%1$s与%2$s通话结束，通话时长：%3$s=%1$@与%2$@通话结束,通话时长:%3$@
嗨，快点击这里返回到%sAPP吧=嗨,快点击这里返回到%@APP吧
蓝灯没有闪烁？=蓝灯没有闪烁?
蓝灯已经闪烁=蓝灯已经闪烁
请将手机连接到以%1$s开头的WiFi上，连接成功后请返回%2$sAPP=请将手机连接到以%1$@开头的WiFi上,连接成功后请返回%2$@APP
请输入当前WiFi的密码，然后进入下一步=请输入当前WiFi的密码,然后进入下一步
点击箭头选择WiFi=点击箭头选择WiFi
等待接听=等待接听
接听=接听
说点什么吧=说点什么吧
按住说话=按住说话
如果您有任何疑问，请拨打客服热线，联系我们的客服人员，感谢您的支持！=如果您有任何疑问,请拨打客服热线,联系我们的客服人员,感谢您的支持!
电话号码方便客服更快的联系到你=电话号码方便客服更快的联系到你
请输入联系电话=请输入联系电话
请输入遇到的问题现象(500字以内)=请输入遇到的问题现象(500字以内)
提交=提交
确定退出登录？=确定退出登录?
修改群名=修改群名
清空所有聊天记录=清空所有聊天记录
群二维码=群二维码
大=大
中=中
小=小
静音=静音
使用微信APP扫描上面的二维码即可关注我们，或者您也可以搜索公众号：小豚当家=使用微信APP扫描上面的二维码即可关注我们,或者您也可以搜索公众号:小豚当家
请确保设备已装上电池，并且保持电量充足=请确保设备已装上电池,并且保持电量充足
设备此时可能已经进入休眠状态，请按呼叫键唤醒设备=设备此时可能已经进入休眠状态,请按呼叫键唤醒设备
若还是没有看到蓝灯闪烁，则请用顶针长按reset键直到"滴"声响起，设备重启后蓝灯将会闪烁并且发出"欢迎使用%s智能门铃"的提示音=若还是没有看到蓝灯闪烁,则请用顶针长按reset键直到"滴"声响起,设备重启后蓝灯将会闪烁并且发出"欢迎使用%@智能门铃"的提示音
设备连接中=设备连接中
请尽量使您的设备靠近路由器，并确保网络环境良好=请尽量使您的设备靠近路由器,并确保网络环境良好
小豚还在等你哦！=小豚还在等你哦!
快快点击按钮来添加属于你的小豚吧！=快快点击按钮来添加属于你的小豚吧!
进入群聊=进入群聊
添加过程出了一点小问题=添加过程出了一点小问题
可能是您的门铃连接的WiFi有问题，导致未成功连接门铃，请选择门铃可用的WiFi再试一次哦！=可能是您的门铃连接的WiFi有问题,导致未成功连接门铃,请选择门铃可用的WiFi再试一次哦!
返回设备首页=返回设备首页
重新添加设备=重新添加设备
请选择一台设备来创建群=请选择一台设备来创建群
语音=语音
松开结束=松开结束
录音时间太短=录音时间太短
完成=完成
您的账号已被限制，无法获取验证码=您的账号已被限制,无法获取验证码
%s录制了一条留言=%@录制了一条留言
暂时没有消息哦=暂时没有消息哦
关闭=关闭
%s呼叫取消=%@呼叫取消
免提=免提
正在接通=正在接通
图片=图片
保存=保存
确认新密码=确认新密码
保存成功=保存成功
感谢您的建议，您的反馈是我们前进的动力，我们会尽快处理！=感谢您的建议,您的反馈是我们前进的动力,我们会尽快处理!
无效的二维码=无效的二维码
该群已解散=该群已解散
超时=超时
消息提醒设置说明=消息提醒设置说明
请检查系统设置或者第三方软件里是否禁止了小豚当家调用摄像头=请检查系统设置或者第三方软件里是否禁止了小豚当家调用摄像头
请插入SD卡=请插入SD卡
未找到该图片=未找到该图片
您确定要退出添加设备吗？=您确定要退出添加设备吗?
下载失败=下载失败
消息不能为空=消息不能为空
录音失败，录音时间太短或请确认是否开启麦克风权限=录音失败,录音时间太短或请确认是否开启麦克风权限
没有更多消息了，不要再拉啦=没有更多消息了,不要再拉啦
未获取到文件信息=未获取到文件信息
还可以录制%s秒=还可以录制%@秒
发送=发送
相册=相册
拍摄=拍摄
确定要清空聊天记录吗？=确定要清空聊天记录吗?
内容不能为空=内容不能为空
保存到了：=保存到了:
保存失败=保存失败
下载升级文件失败=下载升级文件失败
原图=原图
没有更多了=没有更多了
连接失败=连接失败
网络异常=网络异常
请先选择WiFi=请先选择WiFi
WiFi名过长=WiFi名过长
WiFi密码过长=WiFi密码过长
手机号不能为空=手机号不能为空
手机号格式不正确=手机号格式不正确
密码不能为空=密码不能为空
密码必需同时包含数字和字母，长度在6-18位=密码必需同时包含数字和字母,长度在6-18位
正在下载=正在下载
已是最新版本=已是最新版本
验证码错误=验证码错误
两次密码不一致=两次密码不一致
发送失败=发送失败
新密码=新密码
去设置=去设置
我已设置=我已设置
如何设置=如何设置
无法自动跳转，请点击如何设置查看设置教程！=无法自动跳转,请点击如何设置查看设置教程!
请选择要加入的群组=请选择要加入的群组
设备添加成功，快去体验吧！=设备添加成功,快去体验吧!
门铃对WiFi有什么要求？=门铃对WiFi有什么要求?
选择信号较强的WiFi，正确填写WiFi密码后即可快速让设备联网=选择信号较强的WiFi,正确填写WiFi密码后即可快速让设备联网
以下问题可能导致设备联网失败，建议避免：=以下问题可能导致设备联网失败,建议避免:
如果您家是双频路由器，请检查设备连接的WiFi是否是5GHz频段的WiFi，请让设备连接2.4GHz频段的WiFi;=如果您家是双频路由器,请检查设备连接的WiFi是否是5GHz频段的WiFi,请让设备连接2.4GHz频段的WiFi;
设备暂时不支持WPA/WPA2企业级的WiFi，请选择其他WiFi;=设备暂时不支持WPA/WPA2企业级的WiFi,请选择其他WiFi;
检查是否开启了WiFi防蹭网，此设置可能会导致设备无法正常联网.您可以临时关闭防蹭网，设备成功联网后再恢复路由器设置即可;=检查是否开启了WiFi防蹭网,此设置可能会导致设备无法正常联网.您可以临时关闭防蹭网,设备成功联网后再恢复路由器设置即可;
如果您家的WiFi是桥接的，因为桥接的原因可能会导致您的网络非常不稳定，建议连接非桥接的WiFi;=如果您家的WiFi是桥接的,因为桥接的原因可能会导致您的网络非常不稳定,建议连接非桥接的WiFi;
不再提醒=不再提醒
门铃来电提醒设置说明=门铃来电提醒设置说明
这台设备已经被%s绑定了，请联系这个用户解绑这台设备后，您才能绑定这台设备=这台设备已经被%@绑定了,请联系这个用户解绑这台设备后,您才能绑定这台设备
重要提醒=重要提醒
为了确保您的手机能接收到门铃来电，请设置以下权限：=为了确保您的手机能接收到门铃来电,请设置以下权限:
打开自启动和关联启动=打开自启动和关联启动
关闭锁屏清理=关闭锁屏清理
关闭通知消息屏蔽=关闭通知消息屏蔽
打开自启动=打开自启动
关闭后台冻结和自动优化=关闭后台冻结和自动优化
打开后台运行=打开后台运行
后台管理选择允许后台运行=后台管理选择允许后台运行
打开允许通知和悬浮通知=打开允许通知和悬浮通知
设置神隐模式为无限制=设置神隐模式为无限制
请用听筒接听=请用听筒接听
去连接设备=去连接设备
如何连接设备？=如何连接设备?
点击"%1$s"系统会自动跳转至WiFi列表中，连接%2$s开头的WiFi，如下图所示：\n如无法跳转，请手动前往WiFi列表=点击"%1$@"系统会自动跳转至WiFi列表中,连接%2$@开头的WiFi,如下图所示:\n如无法跳转,请手动前往WiFi列表
连接成功后，点击手机屏幕上方弹出的提示横幅跳转回%1$s(需打开通知横幅开关)\n如未接收到提示，请手动回到%2$s=连接成功后,点击手机屏幕上方弹出的提示横幅跳转回%1$@(需打开通知横幅开关)\n如未接收到提示,请手动回到%2$@
回到%s，等待连接，1分钟内即可完成连接=回到%@,等待连接,1分钟内即可完成连接
现在=现在
打开允许通知=打开允许通知
我已复位，下一步=我已复位,下一步
长按开锁=长按开锁
设备信息=设备信息
分享列表=分享列表
修改管理员密码=修改管理员密码
设备昵称=设备昵称
请选择要添加的设备=请选择要添加的设备
智能音频门铃=智能音频门铃
智能视频门铃=智能视频门铃
智能锁=智能锁
开锁记录=开锁记录
蓝牙处于关闭状态=蓝牙处于关闭状态
搜索不到%s？=搜索不到%@?
连接蓝牙=连接蓝牙
正在搜索蓝牙=正在搜索蓝牙
复位智能锁=复位智能锁
暂无可分享的用户=暂无可分享的用户
分享锁=分享锁
没有进入设置状态，请复位智能锁=没有进入设置状态,请复位智能锁
记录与影像=记录与影像
语音接听=语音接听
听筒=听筒
高清=高清
标清=标清
流畅=流畅
产品名称=产品名称
小豚当家智能视频门铃=小豚当家智能视频门铃
请尽量使您的手机靠近设备，以确保通信正常=请尽量使您的手机靠近设备,以确保通信正常
来访记录=来访记录
报警设置=报警设置
时间设置=时间设置
画面与声音=画面与声音
删除=删除
暂无已分享的用户=暂无已分享的用户
确定将设备分享？=确定将设备分享?
分享之后，该好友将拥有智能锁的开锁权限=分享之后,该好友将拥有智能锁的开锁权限
确定删除TA的智能锁权限？=确定删除TA的智能锁权限?
删除分享之后，该好友将失去智能锁的权限=删除分享之后,该好友将失去智能锁的权限
分享者信息=分享者信息
删除设备=删除设备
蓝牙开锁=蓝牙开锁
门卡开锁=门卡开锁
临时密码开锁=临时密码开锁
用户密码开锁=用户密码开锁
管理员密码开锁=管理员密码开锁
钥匙开锁=钥匙开锁
遥控开锁=遥控开锁
指纹开锁=指纹开锁
确定要删除这个设备吗？=确定要删除这个设备吗?
删除之后，该设备将从你的设备列表中彻底移除=删除之后,该设备将从你的设备列表中彻底移除
到=到
低=低
中=中
高=高
人员逗留报警=人员逗留报警
灵敏度设置=灵敏度设置
防拆报警=防拆报警
电量不足报警=电量不足报警
图像设置=图像设置
视频制式=视频制式
声音设置=声音设置
室内机铃声=室内机铃声
设备时间=设备时间
设备时区=设备时区
选择时区=选择时区
远程记录=远程记录
本地影像=本地影像
设备未联网=设备未联网
所在群：%s=所在群:%@
群名不能为空！=群名不能为空!
登录超时=登录超时
连接成功=连接成功
连接失败=连接失败
正在连接智能锁...=正在连接智能锁...
选择的时间不正确=选择的时间不正确
未查询到设备=未查询到设备
正在打开蓝牙...=正在打开蓝牙...
分享成功=分享成功
开始日期=开始日期
结束日期=结束日期
年=年
月=月
日=日
筛选=筛选
开始时间不能大于结束时间=开始时间不能大于结束时间
没有找到相关影像=没有找到相关影像
请选择开始时间=请选择开始时间
请选择结束时间=请选择结束时间
全选=全选
暂无影像=暂无影像
已选(%s)=已选(%@)
请选择要删除的影像=请选择要删除的影像
白光灯：开启=白光灯:开启
白光灯：关闭=白光灯:关闭
没有找到相关记录=没有找到相关记录
暂无记录=暂无记录
正在同步数据=正在同步数据
同步数据完成=同步数据完成
设备未连接=设备未连接
开锁者=开锁者
设备时间有误，需要校对时间=设备时间有误,需要校对时间
加载中=加载中
发送失败：%s=发送失败:%@
访客呼叫=访客呼叫
暂不支持输入表情=暂不支持输入表情
群名不能为空！=群名不能为空!
绑定成功=绑定成功
全部=全部
视频=视频
请关闭WLAN+模式=请关闭WLAN+模式
连接设备热点=连接设备热点
(如遇网络诊断提示属于正常现象，请忽略)=(如遇网络诊断提示属于正常现象,请忽略)
已经选中%s项=已经选中%@项
生成开锁密码=生成开锁密码
立刻生成=立刻生成
生成临时密码=生成临时密码
分享=分享
通过群用户分享=通过群用户分享
通过二维码分享=通过二维码分享
临时密码=临时密码
我知道了，去生成=我知道了,去生成
临时密码在有效期内可多次开锁，适合有人来访时使用，切勿轻易泄露！=临时密码在有效期内可多次开锁,适合有人来访时使用,切勿轻易泄露!
亲友不在身边，通过群成员分享=亲友不在身边,通过群成员分享
智能锁分享二维码=智能锁分享二维码
二维码仅限扫描一次，%s分钟内有效=二维码仅限扫描一次,%@分钟内有效
重新进入将更新=重新进入将更新
二维码已失效=二维码已失效
收到一台分享设备=收到一台分享设备
确认接收=确认接收
来自%s的分享=来自%@的分享
接收分享后将获取分享设备的访客权限=接收分享后将获取分享设备的访客权限
请选择密码的有效期=请选择密码的有效期
正在生成密码=正在生成密码
生成结果=生成结果
嗨，%1$s智能锁的开锁密码是：%2$s，密码的有效期是：%3$s到%4$s，赶快去使用吧！=嗨,%1$@智能锁的开锁密码是:%2$@,密码的有效期是:%3$@到%4$@,赶快去使用吧!
接收成功=接收成功
分享给群成员=分享给群成员
服务时间：周一至周五=服务时间:周一至周五
紧急问题请发送邮件至%s=紧急问题请发送邮件至%@
复位操作如图所示=复位操作如图所示
开启后盖，用顶针长按Reset键直到恢复出厂设置确认信息响起，确认后即可复位成功=开启后盖,用顶针长按Reset键直到恢复出厂设置确认信息响起,确认后即可复位成功
搜索不到%s可能由以下原因造成：=搜索不到%@可能由以下原因造成:
智能锁未唤醒，请通过触摸智能锁的键盘来唤醒智能锁=智能锁未唤醒,请通过触摸智能锁的键盘来唤醒智能锁
手机距离智能锁太远，请将手机尽可能靠近智能锁=手机距离智能锁太远,请将手机尽可能靠近智能锁
选择国家与地区=选择国家与地区
欢迎登录=欢迎登录
输入手机号=输入手机号
输入验证码=输入验证码
验证码已发送至手机：%s=验证码已发送至手机:%@
%s秒后重新获取=%@秒后重新获取
开锁失败=开锁失败
%s可能已被复位，请尝试重新添加设备=%@可能已被复位,请尝试重新添加设备
输入密码=输入密码
分钟=分钟
小时=小时
天=天
